intro	Hello! How may I help you?
outro	Thank you for the chat! Bye bye!
repeat	REPEAT_PREVIOUS_ACTION
rephrase	Sorry I am a bit confused! Can you please rephrase?
reset	Ok, I have just reset my state. What do you want to talk about?
stupid	I am sorry for letting you down
bad_language	Please, be nice!
wrong_answer	I am sorry for the confusion. Can you please rephrase?
funny	I am happy that I make you laugh!
doing_well	That's great!
compliment	I am really happy for this!
debug	REPORT_DEBUG_STATE
can_do	Yes, you can!
cant_do	Unfortunately, I can't do this
request_more	Can I help you with anything else?
have_feelings	No, I do not have feelings. I am just a pipeline of deep learning models
topic_switch	Lets talk about something else. What do you have in mind?
describe_pipeline	Well, I am using state-of-the-art NLP models like mpnet to understand your intents and the semantics of your input on top of an LSTM that tracks the state of the dialogue.
tracking	Yes, I am just tracking the questions, since this will make me better
tell_name	Unfortunately, I have not be given a name yet!
describe_self	Well, I am an under-development chatbot for the AI4EU project
tell_feelings	Currently I have no feelings! But lets say that I am fine!
tell_contact_details	Please, send an email to my creator papadako@ics.forth.gr
tell_origin	I have no origin! Currently I live in the memory of a server called pangaia
tell_creator	I was developed by Panagiotis Papadakos from FORTH-ICS using the deeppavlov dialogue framework
tell_smart	No, I am not smart
tell_bot	Yes, I am a bot
tell_human	No, I am not a human
tell_age	I have no age, since I am not alive
tell_how_to_help	You can help by asking questions. This will help my developer in improving me
tell_time	TIME_FUNCTION
tell_date	DATE_FUNCTION
tell_self_opinion	I want to constantly get better in chatting with people
tell_self_improve	By asking me questions
tell_opinion	Unfortunately, I am not able to express opinions
skills	You can ask me questions about the AI4EU project and AI in general! I can also help you find resources in the platform! I might also be able to answer some general questions!
ai4eu_web_search_api_call	AI4EU_WEB_SEARCH_API_CALL
ai4eu_asset_search_api_call	AI4EU_ASSET_SEARCH_API_CALL
ai4eu_qa_api_call	AI4EU_QA_API_CALL
more_details	Ok, what exactly are you looking for?
ask_which_mode	Do you want to explore resources or make general questions about the project and AI?
ask_which_resources	Are you looking for assets in the AI4EU catalogue or web resources?
tell_slots	You can select values for the following slots for AI4EU assets: research areas, asset type, and technical and business categories
tell_researchAreas	The available research areas are collaborative AI, explainable AI, integrative AI, physical AI and verifiable AI
tell_assetTypes	The available asset types are datasets, docker containers, as as service, executables, notebooks, libraries, and ML models
tell_technicalCategories	The technical categories include AI ethics, AI services, audio processing, automated reasoning, commonsense reasoning, computer vision, connected and automated vehicles, constraints and satisfiability, knowledge representation, machine learning, multi-agent systems, NLP, optimization, philosophy of AI, planning and scheduling, robotics and automation, and search
tell_businessCategories	The business categories include agriculture, cloud edge infrastructure, cultural heritage, earth observation, energy, healthcare, manufacturing, maritime sector, public services, regional engagement DIHS, telecommunications and transportations
request_researchArea	What is the research area of interest?
request_assetType	What is the asset type that you are looking for?
request_technicalCategory	What technical category do you want?
request_businessCategory	What business category do you want?
tell_resource_options	I can tell you its url, title, content, score, summary, and its keywords
tell_resource_url	TELL_RESOURCE_URL
tell_resource_title	TELL_RESOURCE_TITLE
tell_resource_content	TELL_RESOURCE_CONTENT
tell_resource_score	TELL_RESOURCE_SCORE
tell_resource_summary	TELL_RESOURCE_SUMMARY
tell_resource_keywords	TELL_RESOURCE_KEYWORDS
tell_current_in_focus	TELL_CURRENT_IN_FOCUS
tell_next_in_focus	TELL_NEXT_IN_FOCUS
tell_first_in_focus	TELL_FIRST_IN_FOCUS
tell_second_in_focus	TELL_SECOND_IN_FOCUS
tell_previous_in_focus	TELL_PREVIOUS_IN_FOCUS
tell_num_of_objects_in_focus	TELL_NUM_OF_OBJECTS_IN_FOCUS
clear_slots	I cleared the slots. Anything else?
about_what	About what?
